000000000000000000000000000000
061111111431111111114412111110
011111111111111111121111111110
000000000011114111111111141110
011143411111111111111211111110
011111111111111444111111112110
011114111111111431111111111110
011111111111111111110000000000
011144111111111411111111111110
011111111111111111111211111110
011111114111121121111111411110
011111111111111111111111114110
014111000000000000000111113410
011111111111143111111111111110
011111111111111111114111111110
012111411111111411111111111110
011111111111111131111111111110
011124111111111111111111141110
011111111411111211111141111110
011111113111111111111111111110
011421111111111111241111111110
011311111111111111111111111310
000000000000000000000000011110
011111111111111124111111111410
011124111111111111111111111110
014111111111111111341111111110
013111111111112111111111111110
011111112411111111111141111110
011111111111111111111111111115
000000000000000000000000000000