000000000000000000000000000000
061111111111421111111111111110
011111111111311111411111211410
011111121111111111311111111110
000000000000000000001111111110
011411111112113444411121111110
011311111111111111111111111110
044111100000000000000000000000
011111111111111111111441111110
011142211111111114411111111110
011131111421111111111211114110
011111111111114111111111111110
011141111111111111111111111110
000000000000000000000000004110
011114444431111111111111113110
011111111111112221111111111110
011442311111111111114411111110
011111111142111111111111111410
011111111111131111111421111110
014411211114000000000000000000
013111111111111111411111114110
011111431111111421111111141110
011111111111111111111114111110
011344121111111111111111111310
000000000000000000000001111410
011111444211111111111114211110
011111111111111111132111141110
011111412111111111141111111110
011111311111111111111111111115
000000000000000000000000000000