000000000000000000000000000000
061111101111111111144431111110
011114201111211111111141111110
011113101111441112111111114430
011121101111111111111111111110
014111101111211113110111111110
012111101141111444110111111110
031141101111111111110111144120
011121101111111121110111111110
014111101121111111110111111110
011121101111111111110111411110
011114101111144111110111311110
011113101111113111210111111110
034111101111111111110141111110
011111101121111111110111111140
011141101111111111110111121110
012111101111111443110141111110
011111204411111121110111111110
011411103111111111110121111110
011111101111111111110111144110
011111101111141111110111111110
011134111111111111430144111110
011111111111111111110131111110
014112111111112211110111111110
011114112111431111110111111440
011111111111111411110141111110
011221111141111111110111111110
011111111131112211130111141110
011111111111111111110111111115
000000000000000000000000000000