000000000000000000000000000000
061111111111111111211111111110
011111111443111111111111111110
011111111111111111111111111110
000000000011111111114411111110
011113111111111111114111111110
011111111111111111111111111110
011111141211111111111111114110
011111111111141111111111111110
011111111111111111111114111110
011111411111111112211111111110
011111311111111111111111111110
011111111111111111111111221110
011111111111111111100000000000
011144441111111111111111121110
011123111111111111122111111110
011111111111111143111111111430
011111111111111111111111111110
011141111111111112111114111110
011111111111141111111111111110
011112111111111111111111111110
000000000000111111111214311110
011342111111111411111111111110
011111111111111311111111111110
011111114111111111411111121110
011211111111111211111111141110
011111341111111111431111111110
011111111111111111111111121110
011111111111114111111111111115
000000000000000000000000000000