000000000000000000000000000000
061112104441121111114403412210
011111404311111112111301111110
011111101111141111114101111115
014111104111111022111014112110
013111101111114011411101111110
011141101111111011111101111410
011211101111111011111101121110
011111101114111011214101111110
011411101111111011111101114110
011111101111111011111101112230
011111101112114014211101111110
011112401111113011111101411110
011111104111111011114101111110
011111101121111011111101121110
044211101111111011111101411110
031111101111141011411201311410
011111101111111013111101111110
011114401111111011111101111110
011111301111111012211101122110
011111101111411011111101111110
011241101412211011444101141110
011111101111111011131101111110
011111101111111011411101211110
011411101111144011111101111410
011111101111111011221101111110
011111103411111011111401111110
011111111221111011111111112110
011114111111411044311111114110
000000000000000000000000000000